"filename", "language", "Dart", "comment", "blank", "total"
"/var/home/mdd/文档/毕业设计/auto_test_front/lib/entity/user.dart", "Dart", 17, 0, 2, 19
"/var/home/mdd/文档/毕业设计/auto_test_front/lib/main.dart", "Dart", 117, 0, 17, 134
"/var/home/mdd/文档/毕业设计/auto_test_front/lib/page/homePage.dart", "Dart", 149, 0, 11, 160
"/var/home/mdd/文档/毕业设计/auto_test_front/lib/page/loginPage.dart", "Dart", 199, 2, 7, 208
"/var/home/mdd/文档/毕业设计/auto_test_front/lib/page/myPage.dart", "Dart", 12, 0, 4, 16
"/var/home/mdd/文档/毕业设计/auto_test_front/lib/page/problemSetPage.dart", "Dart", 12, 0, 3, 15
"/var/home/mdd/文档/毕业设计/auto_test_front/lib/page/settingPage.dart", "Dart", 141, 0, 8, 149
"/var/home/mdd/文档/毕业设计/auto_test_front/lib/page/stuManPage.dart", "Dart", 12, 0, 4, 16
"/var/home/mdd/文档/毕业设计/auto_test_front/lib/page/testPage.dart", "Dart", 12, 0, 3, 15
"/var/home/mdd/文档/毕业设计/auto_test_front/lib/status.dart", "Dart", 12, 0, 1, 13
"/var/home/mdd/文档/毕业设计/auto_test_front/lib/widget/themeDropdownbtn.dart", "Dart", 173, 0, 6, 179
"Total", "-", 856, 2, 66, 924