"filename", "language", "Dart", "comment", "blank", "total"
"/var/home/mdd/文档/毕业设计/auto_test_front/lib/entity/user.dart", "Dart", 19, 0, 2, 21
"/var/home/mdd/文档/毕业设计/auto_test_front/lib/main.dart", "Dart", 119, 0, 18, 137
"/var/home/mdd/文档/毕业设计/auto_test_front/lib/page/homePage.dart", "Dart", 152, 0, 11, 163
"/var/home/mdd/文档/毕业设计/auto_test_front/lib/page/loginPage.dart", "Dart", 192, 2, 7, 201
"/var/home/mdd/文档/毕业设计/auto_test_front/lib/page/myPage.dart", "Dart", 12, 0, 4, 16
"/var/home/mdd/文档/毕业设计/auto_test_front/lib/page/problemSetPage.dart", "Dart", 12, 0, 3, 15
"/var/home/mdd/文档/毕业设计/auto_test_front/lib/page/settingPage.dart", "Dart", 188, 0, 11, 199
"/var/home/mdd/文档/毕业设计/auto_test_front/lib/page/stuManPage.dart", "Dart", 231, 0, 10, 241
"/var/home/mdd/文档/毕业设计/auto_test_front/lib/page/testPage.dart", "Dart", 12, 0, 3, 15
"/var/home/mdd/文档/毕业设计/auto_test_front/lib/status.dart", "Dart", 12, 0, 2, 14
"/var/home/mdd/文档/毕业设计/auto_test_front/lib/widget/dataColumList.dart", "Dart", 0, 0, 1, 1
"/var/home/mdd/文档/毕业设计/auto_test_front/lib/widget/pwdModDialog.dart", "Dart", 106, 0, 4, 110
"/var/home/mdd/文档/毕业设计/auto_test_front/lib/widget/themeDropdownbtn.dart", "Dart", 173, 0, 6, 179
"Total", "-", 1228, 2, 82, 1312